20
15
0 0 0 0 0 0 0 0 0 0 0 0 0 0 0 0 0 0 0 0 
0 0 0 0 0 0 0 0 0 0 0 0 0 0 0 0 0 0 0 0 
0 0 0 0 0 0 0 0 0 0 0 0 0 0 0 0 0 0 0 0 
0 0 0 0 0 0 0 0 0 0 0 1 0 0 0 0 0 0 0 0 
0 0 1 1 1 0 0 0 0 2 12 12 12 4 0 0 0 0 0 0 
0 12 12 12 12 12 4 0 1 0 8 8 8 0 0 0 0 0 0 0 
0 8 8 8 8 8 12 12 12 4 8 8 8 0 5 0 0 0 0 0 
0 8 8 8 8 8 8 8 8 0 8 8 8 0 0 0 0 0 0 0 
0 0 0 0 0 0 0 0 0 0 0 0 0 0 0 0 0 0 0 0 
0 0 0 0 0 0 0 0 0 0 0 12 0 0 0 0 0 0 0 0 
0 0 0 0 0 0 0 0 0 0 0 0 0 0 9 6 7 3 0 0 
0 0 1 0 0 0 0 0 0 0 0 0 1 0 0 1 0 0 0 0 
2 12 9 6 7 7 3 4 0 0 2 12 9 7 3 12 4 0 0 0 
0 8 8 8 8 8 10 12 4 2 12 11 8 8 8 8 0 0 0 0 
0 8 8 8 8 8 8 8 0 0 8 8 8 8 8 8 0 0 0 0 

